15
15
0 
0 0 0 0 0 0 0 0 0 0 0 0 0 0 0 
0 0 0 0 0 0 0 0 0 0 0 0 0 0 0 
0 0 0 0 0 0 0 0 0 0 0 0 0 0 0 
0 0 0 0 0 0 0 0 0 0 0 0 0 0 0 
0 0 106 106 106 0 0 0 106 106 106 0 0 0 0 
0 106 106 106 106 106 0 106 106 106 106 106 0 0 0 
0 106 106 106 106 106 106 106 106 106 106 106 0 0 0 
0 106 106 106 106 106 106 106 106 106 106 106 0 0 0 
0 106 106 106 106 106 106 106 106 106 106 106 0 0 0 
0 0 106 106 106 106 106 106 106 106 106 0 0 0 0 
0 0 0 106 106 106 106 106 106 106 0 0 0 0 0 
0 0 0 0 106 106 106 106 106 0 0 0 0 0 0 
0 0 0 0 0 106 106 106 0 0 0 0 0 0 0 
0 0 0 0 0 0 106 0 0 0 0 0 0 0 0 
0 0 0 0 0 0 0 0 0 0 0 0 0 0 